1111111111111111111111111111111111
1E0000001000000C00000C000001000001
1010010100100000101001000000010101
1010010010101010001001000000010101
1P0000000C00C0001000100010010000C1
1111111111111111111111111111111111